5,5,4,5,5,5,5,5,5,5,5,5,5,5,5,5,5,5,5,5,5,5,5,5,5
5,5,4,5,5,5,5,5,5,5,5,5,5,5,5,5,5,5,5,5,5,5,5,5,5
5,5,4,5,5,5,5,5,5,5,5,5,5,5,5,5,5,5,5,5,5,5,5,5,5
5,5,4,5,5,5,5,5,5,5,5,5,5,5,5,5,5,5,5,5,5,5,5,5,5
5,5,4,5,5,5,5,0,1,1,1,1,1,1,1,1,1,1,1,2,5,5,5,5,5
5,5,4,5,5,5,5,4,5,5,5,5,5,5,5,5,5,5,5,4,5,5,5,5,5
5,5,4,5,5,5,5,4,5,5,5,5,5,5,5,5,5,5,5,4,5,5,5,5,5
5,5,4,5,5,5,5,4,5,5,5,5,5,5,5,5,5,5,5,4,5,5,5,5,5
5,5,4,5,5,5,5,4,5,5,0,1,1,1,1,2,5,5,5,4,5,5,5,5,5
5,5,4,5,5,5,5,4,5,5,4,5,5,5,5,4,5,5,5,4,5,5,5,5,5
5,5,4,5,5,5,5,4,5,5,4,5,5,5,5,4,5,5,5,4,5,5,5,5,5
5,5,4,5,5,5,5,4,5,5,4,5,5,5,5,4,5,5,5,4,5,5,5,5,5
5,5,4,5,5,5,5,4,5,5,4,5,5,5,5,4,5,5,5,4,5,5,5,5,5
5,5,4,5,5,5,5,4,5,5,4,5,5,5,5,4,5,5,5,4,5,5,5,5,5
5,5,4,5,5,5,5,4,5,5,6,1,5,5,5,4,5,5,5,4,5,5,5,5,5
5,5,4,5,5,5,5,4,5,5,5,5,5,5,5,4,5,5,5,4,5,5,5,5,5
5,5,4,5,5,5,5,4,5,5,5,5,5,5,5,4,5,5,5,4,5,5,5,5,5
5,5,4,5,5,5,5,4,5,5,5,5,5,5,5,4,5,5,5,4,5,5,5,5,5
5,5,4,5,5,5,5,6,1,1,1,1,1,1,1,8,5,5,5,4,5,5,5,5,5
5,5,4,5,5,5,5,5,5,5,5,5,5,5,5,5,5,5,5,4,5,5,5,5,5
5,5,4,5,5,5,5,5,5,5,5,5,5,5,5,5,5,5,5,4,5,5,5,5,5
5,5,4,5,5,5,5,5,5,5,5,5,5,5,5,5,5,5,5,4,5,5,5,5,5
5,5,6,1,1,1,1,1,1,1,1,1,1,1,1,1,1,1,1,8,5,5,5,5,5
5,5,5,5,5,5,5,5,5,5,5,5,5,5,5,5,5,5,5,5,5,5,5,5,5
5,5,5,5,5,5,5,5,5,5,5,5,5,5,5,5,5,5,5,5,5,5,5,5,5
